filename, language, JSON, Gradle, Java, Batch, Properties, comment, blank, total
.wpilib\wpilib_preferences.json, JSON, 6, 0, 0, 0, 0, 0, 0, 6
build.gradle, Gradle, 0, 38, 0, 0, 0, 17, 7, 62
gradle\wrapper\gradle-wrapper.properties, Properties, 0, 0, 0, 0, 5, 0, 1, 6
gradlew.bat, Batch, 0, 0, 0, 61, 0, 0, 24, 85
settings.gradle, Gradle, 0, 24, 0, 0, 0, 0, 2, 26
src\main\java\frc\controller\CustomButtonBoard.java, Java, 0, 0, 36, 0, 0, 13, 16, 65
src\main\java\frc\controller\CustomDPad.java, Java, 0, 0, 44, 0, 0, 9, 16, 69
src\main\java\frc\controller\CustomDPadButton.java, Java, 0, 0, 22, 0, 0, 9, 8, 39
src\main\java\frc\controller\CustomGamepad.java, Java, 0, 0, 55, 0, 0, 9, 23, 87
src\main\java\frc\controller\CustomJoystick.java, Java, 0, 0, 41, 0, 0, 9, 13, 63
src\main\java\frc\robot\Main.java, Java, 0, 0, 9, 0, 0, 16, 5, 30
src\main\java\frc\robot\OI.java, Java, 0, 0, 52, 0, 0, 13, 26, 91
src\main\java\frc\robot\Robot.java, Java, 0, 0, 104, 0, 0, 18, 36, 158
src\main\java\frc\robot\RobotMap.java, Java, 0, 0, 110, 0, 0, 7, 37, 154
src\main\java\frc\robot\commands\Drive\DriveControl.java, Java, 0, 0, 33, 0, 0, 12, 12, 57
src\main\java\frc\robot\commands\Drive\ToggleBackJack.java, Java, 0, 0, 26, 0, 0, 12, 10, 48
src\main\java\frc\robot\commands\Drive\ToggleFrontJack.java, Java, 0, 0, 26, 0, 0, 12, 10, 48
src\main\java\frc\robot\commands\Intake\IntakeIn.java, Java, 0, 0, 29, 0, 0, 14, 11, 54
src\main\java\frc\robot\commands\Intake\IntakeOut.java, Java, 0, 0, 30, 0, 0, 14, 11, 55
src\main\java\frc\robot\commands\Intake\IntakeStop.java, Java, 0, 0, 28, 0, 0, 16, 10, 54
src\main\java\frc\robot\commands\Intake\PoweredIntakeIn.java, Java, 0, 0, 29, 0, 0, 13, 11, 53
src\main\java\frc\robot\commands\Lift\LiftControl.java, Java, 0, 0, 29, 0, 0, 12, 11, 52
src\main\java\frc\robot\commands\Lift\PIDLift.java, Java, 0, 0, 50, 0, 0, 12, 19, 81
src\main\java\frc\robot\commands\Lift\PIDLiftSmart.java, Java, 0, 0, 53, 0, 0, 12, 20, 85
src\main\java\frc\robot\commands\Lift\TogglePIDEnabled.java, Java, 0, 0, 25, 0, 0, 12, 9, 46
src\main\java\frc\robot\commands\Wrist\ToggleHatchMode.java, Java, 0, 0, 26, 0, 0, 12, 9, 47
src\main\java\frc\robot\commands\Wrist\WristControl.java, Java, 0, 0, 29, 0, 0, 12, 13, 54
src\main\java\frc\robot\subsystems\Drive.java, Java, 0, 0, 66, 0, 0, 11, 24, 101
src\main\java\frc\robot\subsystems\Intake.java, Java, 0, 0, 32, 0, 0, 19, 16, 67
src\main\java\frc\robot\subsystems\Lift.java, Java, 0, 0, 56, 0, 0, 14, 29, 99
src\main\java\frc\robot\subsystems\Wrist.java, Java, 0, 0, 23, 0, 0, 9, 11, 43
vendordeps\Phoenix.json, JSON, 135, 0, 0, 0, 0, 0, 0, 135
Total, -, 141, 62, 1063, 61, 5, 338, 450, 2120